111111111111111
100000000010001
100010000000001
101101011001001
100101103100101
100001001100101
100111000011001
101210011000001
100010000001101
110010000111001
111111111111111
