111111111111
102000001101
101001000001
101011011101
101000011001
101110000001
100110111101
100011130001
101000000001
111111111111
