1111111111111111111111111111
1000000000000001110000000001
1010001111000001110000100001
1100000000000000110011100101
1001000001111000000011111001
1001001001100000000000001001
1011021001100000011100000001
1011111000000110000100000001
1011000000000110000100111001
1001001100000110000110001001
1001001000100000001110001001
1001000000100000101110011011
1101111111110000000010011001
1001110000110011000111111001
1111000010110011001111111101
1100000010010011100011111101
1001110000010000100001100001
1001110000010000000001100001
1000010000011110001001101101
1110010010011000000001111001
1010000010011111111111100001
1010001110000000000000010001
1000111300101111100000000101
1000001010101110000010001101
1001001010101110000010011001
1011100000000100011110011001
1001000000000100011110000001
1111111111111111111111111111
