11111111111111111
12000011001000001
10110000000010101
10001110001100001
11100001010000011
10101101010010001
10101100100011111
10000100010100001
10001111010101101
10101000010000001
10001010010001001
10111001001111001
10001000100000001
10100101000001101
10100000011101101
10101010001100031
11111111111111111
